12
-.-.-.-.-.-.-.-.-.-.-.-
-.-.-.-.-.-.-.-.-.-.-.-
-.-.-.G.GS.-.-.-.-.-.-.-
-.-.-.S.W.S.-.-.B.-.-.-
-.-.-.-.S.-.A.B.P.GB.-.-
-.-.-.-.-.-.-.-.B.G.-.-
-.-.-.-.-.-.-.G.-.-.-.-
-.-.-.B.-.-.G.-.-.-.-.-
-.-.B.P.B.S.-.-.-.-.-.-
-.-.G.GB.S.W.S.-.S.-.-.-
-.G.G.-.-.S.-.S.W.S.-.-
-.G.-.-.-.G.-.-.GS.-.-.G