10
-.-.-.-.-.-.-.-.-.-
B.-.-.-.S.-.-.-.-.-
P.B.A.S.W.S.G.-.-.-
B.-.-.-.S.-.G.-.-.-
-.-.-.-.-.-.G.-.-.-
-.-.G.-.-.-.-.S.-.-
-.-.-.B.-.-.S.W.S.-
-.-.B.P.B.S.W.GS.G.G
-.-.-.B.-.-.S.G.G.G
-.-.-.G.-.-.-.G.G.G