15
-.-.-.-.-.-.-.-.-.-.-.-.-.-.-
B.-.-.S.-.-.-.-.-.-.-.-.-.G.-
P.B.AS.W.S.-.G.-.-.-.B.-.-.G.-
B.-.-.S.-.-.G.-.-.B.P.B.-.G.-
-.-.-.-.-.-.G.-.-.-.B.-.-.-.-
-.-.-.-.-.B.-.-.-.-.-.-.-.-.-
-.-.-.-.B.P.B.-.-.-.-.-.G.-.-
-.-.-.-.-.B.-.-.-.-.-.-.G.-.-
-.-.-.-.-.-.-.-.-.-.-.-.-.-.-
-.-.G.-.-.-.-.S.-.-.-.-.-.-.-
-.-.-.B.-.-.S.W.S.-.-.-.G.-.-
-.-.B.P.B.S.W.GS.G.G.-.-.-.-.-
-.-.-.B.-.-.S.G.G.G.-.-.-.-.-
-.-.-.G.-.-.-.G.G.G.-.-.G.-.-
-.-.-.-.-.-.-.-.-.-.-.-.-.-.-