10
-.S.-.-.G.G.-.-.-.-
S.W.S.-.G.G.-.S.-.-
-.S.-.-.-.B.S.W.S.-
-.-.B.-.B.P.B.S.-.-
-.B.P.B.P.B.-.-.-.-
-.-.B.-.B.-.-.G.-.-
-.G.G.-.B.-.-.G.-.-
-.G.G.B.P.B.-.G.-.-
-.-.-.-.B.-.-.G.-.-
-.-.-.-.-.-.-.G.-.A